0,2,2,0,4,2,0,0,2,0,0,0
0,2,2,0,4,4,0,0,2,0,0,6
6,2,2,0,2,2,2,0,1,6,6,6
0,2,2,0,2,4,2,0,1,6,0,6
0,2,2,0,2,3,2,5,2,0,0,0
6,2,2,0,2,2,2,0,2,0,0,0
0,2,2,0,4,0,0,0,2,0,0,0
0,2,2,0,0,5,0,0,2,5,5,0