1,1,1,1,0,0,1,1,1,1,1,1
1,1,1,2,0,0,4,2,0,1,1,1
1,1,1,1,0,1,5,1,0,1,1,1
1,1,1,6,7,7,3,4,6,2,1,1
1,1,1,1,0,1,6,1,0,0,0,1
1,1,1,1,0,0,5,0,0,1,0,1
1,1,1,1,1,1,1,0,1,1,0,1
1,1,1,1,1,1,1,0,0,0,0,1