1,1,1,1,1,1,1,1,1,1,1,1
2,0,4,0,6,0,6,0,0,0,0,1
2,0,7,0,5,0,6,0,0,0,0,1
2,0,5,0,4,3,6,0,0,0,0,1
2,0,6,0,4,0,6,0,7,0,0,1
2,0,4,0,5,0,6,0,0,0,0,1
2,0,5,0,4,0,6,0,0,0,0,1
1,1,1,1,1,1,1,1,1,1,1,1