3,0,0,0,0,0,0,0,0,0,0,0
6,0,0,0,0,0,0,0,0,0,7,0
6,0,0,6,0,0,0,6,6,0,0,0
0,1,1,6,1,1,1,1,1,1,1,0
0,0,0,0,0,0,0,0,0,0,0,0
0,1,1,1,1,0,1,1,0,1,1,1
0,7,0,0,0,0,0,0,5,4,2,0
0,0,1,1,1,1,0,0,0,1,1,1